0 0 0 0 0 0 0 0 0 8
0 8 0 0 0 0 0 0 0 0
0 8 0 0 0 0 0 0 0 0
0 8 0 0 0 0 0 0 0 0
0 0 0 0 0 8 0 0 0 0
x x x x x 0 0 0 0 0
x x x x x 0 0 0 0 0
x x x x x 0 0 0 0 0
x x x x x 0 0 0 0 0
x x x x x 0 0 0 0 0