0 0 0 0 0 0 0 0 0 9
0 9 0 0 0 0 0 0 0 0
0 9 0 0 0 0 0 0 0 0
0 9 0 0 0 0 0 0 0 0
0 0 0 0 0 9 0 0 0 0
x x x x x 0 0 0 0 0
x x x x x 0 0 0 0 0
x x x x x 0 0 0 0 0
x x x x x 9 0 0 0 9
x x x x x 0 0 0 0 0