801000000000
000000000000
L00300000000
00000U010000
l00000000000
000000003000
L00401000050
000000000000
30600030D020
000000000000