E>GH00000000
D00I00000000
C00J00000000
B00K>MNOP000
^0000000v000
n0000000R000
m00dc<a0STUV
l00e00`0000v
^00f00_0000X
ji<g00^]<[ZY