801000000000
000000000000
L00300000000
000001000000
l00000000000
000000300000
L0040100u010
000000000000
30200030d020
000000000000