801000000000
000000000000
L00300000000
00000u010000
l00000000000
000000003000
L00401000010
000000000000
30200030d020
000000000000