000008010
000000000
00d0200R0
800000000
0000000r0
l00000000
0000000R0
300000000
00U0100r0
000000000
000003060
000000000