00000LMNO
00000K00P
00000J00Q
DEFGHI00R
C0000000S
B0000000T
A0000000U
f0000000V
edcba`00W
00000_00X
00000^00Y
00000]\[Z