00000LMNO
00000K00V
00000^00Q
D>FGHI00R
C0000000S
B0000000T
^0000000V
f0000000V
edcb<`00W
00000_00X
00000^00Y
00000]\<Z