EFGH00000000
D00I00000000
C00J00000000
B00KLMNOP000
A0000000Q000
n0000000R000
m00dcba0STUV
l00e00`0000W
k00f00_0000X
jihg00^]\[ZY